#.######
#>>.<^<#
#.<..<<#
#>v.><>#
#<^v^^>#
######.#


######.#
#<^v^^>#
#>v.><>#
#.<..<<#
#>>.<^<#
#.######